XXXXXXXXXX
   XI     
XX       X
XX      XX
XR       X
XXXXXXXX X
XXXXXX   X
XXXXX   XX
X       FX
XXXXXXXXXX